########
#.  .###
#@$#$  #
#$. .$ #
#    $.#
########